NO ./textures/Panorte.png
SO ./textures/Pasur.png
WE ./textures/Paoeste.png
EA ./textures/Paeste.png

F 0,255,255
C 0,255,0

 111111111        111111111111111111 
1000000000111111110000000001000011001
10001000000000000000000000001111100001
1000000000000000000N000000000000000001
10001001000001000001000001000001000001
10000000000000000000000000000000000001
10001000001000001000001000001000001001
10000000000000000000000000000000000001
 100000000000000000000000000000000001
  1000000000000001001100000000000001
   10000000000000010100000000000001
    111111111111111111111111111111