NO ./path_to_the_north_texture
SO ./path_to_the_south_texture
F 220,100,0

WE              ./path_to_the_west_texture
EA ./path_to_the_east_texture

C 225,30,0

11111111111
10001000001
10101011101
10101010001
10101010101
1N100010001
11111111111