NO ./textures/north.png
SO ./textures/south.png
WE ./textures/west.png
EA ./textures/east.png

F 0,255,255
C 0,255,0

1111111
1000001
1001001
1W00001
1001001
1000001
1111111