NO ./textures/north.png
SO ./textures/south.png
WE ./textures/west.png
EA ./textures/east.png

F 0,255,255
C 0,255,0

111111          1111111111111
1000001         100000000001
10010011111111111000000000001
10W0000000000000000000100001
10010011111111111000000000001
1000001         1000000000001
1111111         1111111111111
                            1