NO ./textures/north.png
SO ./textures/south.png
WE ./textures/west.png
EA ./textures/east.png

F 0,255,255
C 0,255,0

1111111111        111111111111111111
10000000001111111100000000001   10001
10001000000000000000000000001111100001
10000000000000000000000000000000000001
10001001000001000001000001000001000001
10000000000000000000000000000000000001
10001000001000001000001000001000001001
10000000000000000000000000000000000001
 100000000000000000000000000000000001
  100000000000000N000000000000000001
   10000000000000000000000000000001
    111111111111111111111111111111