NO ./textures/north.png
SO ./textures/south.png
WE ./textures/west.png
EA ./textures/east.png

F 0,255,255
C 0,255,0

1111111         111111111111
0000001         1000000000001
10010011111111111000000000001
1W000000000000000000000100001
10010011111111111000000000001
1000001         1000000000001
1111111         1111111111111