NO ./textures/north.png
SO ./textures/south.png
WE ./textures/west.png
EA ./textures/east.png

F 0,255,255
C 0,255,0

       
 1111111       1111111
 1000001       10000001
 100100111111111000001      0 
 100W000000000000000001
 100100111111110000001
 1000001      10000001
 1111111      1111111
        